####################
# S               #
################# #
                # #
                # #
                # #
                # #
                # #
                # #
 ################1#############
 #        D                  K#
 # ############################
 # #
 # #
 # #
 # ############################
 #                           2#
 # ############################
 # #
 # #
 # #
 # #
 # #
 # #
 # #
 # #
 # #
 # #
 # #
 # #
 # #
 #F#